codice_regione,regione,codice_provincia,provincia,popolazione_maschi,popolazione_femmine,popolazione
1,Piemonte,1,Torino,1092504,1167019,2259523
1,Piemonte,2,Vercelli,82848,88063,170911
1,Piemonte,3,Novara,179588,189430,369018
1,Piemonte,4,Cuneo,289459,297639,587098
1,Piemonte,5,Asti,105011,109627,214638
1,Piemonte,6,Alessandria,204552,216732,421284
2,Valle d'Aosta,7,Valle d'Aosta,61423,64243,125666
7,Liguria,8,Imperia,103075,110765,213840
7,Liguria,9,Savona,132401,143663,276064
7,Liguria,10,Genova,400324,440856,841180
7,Liguria,11,La Spezia,105960,113596,219556
3,Lombardia,12,Varese,433730,457038,890768
3,Lombardia,13,Como,293884,305320,599204
3,Lombardia,14,Sondrio,88868,92227,181095
3,Lombardia,15,Milano,1576316,1673999,3250315
3,Lombardia,16,Bergamo,552870,561720,1114590
3,Lombardia,17,Brescia,624201,641753,1265954
3,Lombardia,18,Pavia,266741,279147,545888
3,Lombardia,19,Cremona,176880,182075,358955
3,Lombardia,20,Mantova,202666,209626,412292
4,Trentino-Alto Adige,21,Bolzano,262713,268465,531178
4,Trentino-Alto Adige,22,Trento,265497,275601,541098
5,Veneto,23,Verona,454113,472384,926497
5,Veneto,24,Vicenza,424877,437541,862418
5,Veneto,25,Belluno,98519,104431,202950
5,Veneto,26,Treviso,436607,451199,887806
5,Veneto,27,Venezia,414085,439253,853338
5,Veneto,28,Padova,457404,480504,937908
5,Veneto,29,Rovigo,114178,120759,234937
6,Friuli-Venezia Giulia,30,Udine,256276,272515,528791
6,Friuli-Venezia Giulia,31,Gorizia,68522,70881,139403
6,Friuli-Venezia Giulia,32,Trieste,112538,121955,234493
8,Emilia-Romagna,33,Piacenza,140530,146622,287152
8,Emilia-Romagna,34,Parma,220524,231107,451631
8,Emilia-Romagna,35,Reggio nell'Emilia,261563,270328,531891
8,Emilia-Romagna,36,Modena,345394,359999,705393
8,Emilia-Romagna,37,Bologna,489227,525392,1014619
8,Emilia-Romagna,38,Ferrara,166099,179592,345691
8,Emilia-Romagna,39,Ravenna,189390,200066,389456
8,Emilia-Romagna,40,Forli-Cesena,191995,202632,394627
11,Marche,41,Pesaro e Urbino,175224,183662,358886
11,Marche,42,Ancona,227970,243258,471228
11,Marche,43,Macerata,152632,161546,314178
11,Marche,44,Ascoli Piceno,100312,106867,207179
9,Toscana,45,Massa-Carrara,94108,100770,194878
9,Toscana,46,Lucca,187299,200577,387876
9,Toscana,47,Pistoia,140948,151525,292473
9,Toscana,48,Firenze,485167,526182,1011349
9,Toscana,49,Livorno,161309,173523,334832
9,Toscana,50,Pisa,203825,215212,419037
9,Toscana,51,Arezzo,166953,175701,342654
9,Toscana,52,Siena,128603,138594,267197
9,Toscana,53,Grosseto,106993,114636,221629
10,Umbria,54,Perugia,316873,339509,656382
10,Umbria,55,Terni,107946,117687,225633
12,Lazio,56,Viterbo,155227,161803,317030
12,Lazio,57,Rieti,76907,78596,155503
12,Lazio,58,Roma,2081239,2260973,4342212
12,Lazio,59,Latina,284526,290728,575254
12,Lazio,60,Frosinone,240507,248576,489083
15,Campania,61,Caserta,451931,471034,922965
15,Campania,62,Benevento,135931,141087,277018
15,Campania,63,Napoli,1497289,1587601,3084890
15,Campania,64,Avellino,205626,212680,418306
15,Campania,65,Salerno,537713,560800,1098513
13,Abruzzo,66,L'Aquila,147868,151163,299031
13,Abruzzo,67,Teramo,150803,157249,308052
13,Abruzzo,68,Pescara,153590,165319,318909
13,Abruzzo,69,Chieti,187875,197713,385588
14,Molise,70,Campobasso,108750,112488,221238
16,Puglia,71,Foggia,305170,317013,622183
16,Puglia,72,Bari,610856,641138,1251994
16,Puglia,73,Taranto,279656,297100,576756
16,Puglia,74,Brindisi,189878,203097,392975
16,Puglia,75,Lecce,381571,413563,795134
17,Basilicata,76,Potenza,179328,185632,364960
17,Basilicata,77,Matera,97369,100540,197909
18,Calabria,78,Cosenza,345701,360052,705753
18,Calabria,79,Catanzaro,174797,183519,358316
18,Calabria,80,Reggio di Calabria,267428,280581,548009
19,Sicilia,81,Trapani,211304,219188,430492
19,Sicilia,82,Palermo,605997,646591,1252588
19,Sicilia,83,Messina,302546,324330,626876
19,Sicilia,84,Agrigento,211710,223160,434870
19,Sicilia,85,Caltanissetta,126891,135567,262458
19,Sicilia,86,Enna,79853,84935,164788
19,Sicilia,87,Catania,538402,569300,1107702
19,Sicilia,88,Ragusa,159015,161878,320893
19,Sicilia,89,Siracusa,196871,202353,399224
20,Sardegna,90,Sassari,242322,249249,491571
20,Sardegna,91,Nuoro,102780,105770,208550
20,Sardegna,92,Cagliari,208867,222171,431038
6,Friuli-Venezia Giulia,93,Pordenone,153466,159067,312533
14,Molise,94,Isernia,41830,42549,84379
20,Sardegna,95,Oristano,77731,79976,157707
1,Piemonte,96,Biella,84297,91288,175585
3,Lombardia,97,Lecco,166367,171013,337380
3,Lombardia,98,Lodi,113663,116535,230198
8,Emilia-Romagna,99,Rimini,163813,175204,339017
9,Toscana,100,Prato,125536,132180,257716
18,Calabria,101,Crotone,88397,86583,174980
18,Calabria,102,Vibo Valentia,79350,80723,160073
1,Piemonte,103,Verbano-Cusio-Ossola,76820,81529,158349
3,Lombardia,108,Monza e della Brianza,428265,445670,873935
11,Marche,109,Fermo,84789,89011,173800
16,Puglia,110,Barletta-Andria-Trani,192772,197239,390011
20,Sardegna,111,Sud Sardegna,174062,176663,350725